6 6 6 6 6 6 6 6 6 6 6 6 6 6 6 6 6 6 6 6 6 6 6 6 6 6 6 6 6 6 6 6 6 6 6 6 6 6 6 6 6 6 6 6 6 6 6 6 6 6
6 2 2 2 2 2 2 2 2 2 2 2 2 2 2 2 2 2 2 2 6 1 1 1 1 6 1 1 4 4 4 4 4 4 4 4 4 4 4 4 4 4 4 4 2 2 2 2 2 6
6 2 2 2 2 2 2 2 2 2 2 2 2 2 2 2 2 2 2 2 6 1 1 1 1 6 1 1 4 4 4 4 4 4 4 4 4 4 4 4 4 4 4 4 2 2 2 2 2 6
6 1 1 1 1 6 6 6 6 6 6 6 6 6 1 4 4 4 4 1 6 4 4 1 1 1 1 1 1 1 1 1 1 1 1 1 4 1 1 1 1 4 1 1 2 2 2 2 2 6
6 1 1 1 1 6 1 1 1 1 1 1 1 6 1 4 4 4 4 1 6 1 1 1 1 1 1 1 1 1 1 1 1 1 1 1 4 1 1 1 1 0 0 1 2 2 2 2 2 6
6 4 4 1 1 6 1 1 1 1 1 1 1 6 1 4 4 4 4 1 6 1 1 1 1 6 6 6 6 6 6 6 6 6 1 1 4 1 6 6 6 0 0 4 2 2 2 2 2 6
6 4 4 1 1 6 1 1 1 1 1 1 1 6 1 4 4 4 4 1 6 1 4 4 4 6 1 1 1 4 4 4 4 6 1 1 4 1 1 1 6 1 1 1 2 2 2 2 2 6
6 4 4 1 1 6 1 1 1 1 1 1 1 6 1 4 4 4 4 1 6 1 1 1 1 6 1 1 1 4 4 4 4 6 1 1 4 1 1 1 6 1 1 1 2 2 2 2 2 6
6 1 1 1 1 6 1 1 1 1 1 1 1 6 1 4 4 4 4 1 6 6 1 6 6 6 1 1 1 4 4 4 4 6 1 1 4 1 1 1 6 1 1 4 2 2 2 2 2 6
6 1 1 1 1 6 6 6 6 1 6 6 6 6 6 4 4 4 4 1 1 1 1 1 1 1 4 4 4 4 4 4 4 6 1 1 4 1 1 1 6 1 1 1 2 2 2 2 2 6
6 1 1 1 1 1 1 6 1 1 1 1 1 1 6 4 4 4 4 1 1 1 1 1 1 1 4 4 4 4 4 4 4 6 1 1 6 6 6 6 6 1 1 1 2 2 2 2 2 6
6 1 1 4 4 4 1 6 1 1 1 1 1 1 6 4 4 4 4 1 1 1 1 1 1 1 1 1 1 4 4 4 4 6 1 1 1 4 4 4 6 1 1 1 2 2 2 2 2 6
6 1 1 4 4 4 1 6 1 4 4 4 4 1 6 4 4 4 4 1 1 4 4 1 1 1 1 1 1 4 4 4 4 6 1 1 1 4 4 4 6 1 1 1 2 2 2 2 2 6
6 1 1 4 4 4 1 6 1 4 4 1 1 1 6 4 4 4 4 1 1 4 4 1 1 1 1 1 1 4 4 4 4 6 1 1 1 4 4 4 6 1 4 1 2 2 2 2 2 6
6 1 1 4 4 4 1 6 1 4 4 1 1 1 6 4 4 4 4 1 1 4 4 4 4 4 4 1 1 4 4 4 4 6 1 1 4 4 4 4 6 1 1 1 2 2 2 2 2 6
6 1 1 4 4 4 1 6 1 4 4 1 1 1 6 4 4 4 4 1 1 4 4 4 4 4 4 1 1 4 4 4 4 6 1 1 4 4 4 4 6 1 1 1 2 2 2 2 2 6
6 1 1 4 4 4 1 6 1 4 4 4 1 1 6 4 4 4 4 1 1 1 1 1 4 4 4 1 1 4 4 4 4 4 1 1 4 4 4 4 6 1 1 1 2 2 2 2 2 6
6 4 1 1 6 1 1 6 1 1 4 4 1 1 6 4 4 4 4 1 1 1 1 1 4 4 4 1 1 1 1 1 4 4 1 1 4 4 4 4 6 1 1 1 2 2 2 2 2 6
6 1 1 1 6 1 1 6 1 1 4 4 1 1 6 4 4 4 4 4 1 1 1 1 4 4 4 1 1 1 1 1 4 1 1 1 4 4 4 4 6 1 1 4 2 2 2 2 2 6
6 1 1 1 6 1 1 6 1 1 1 1 1 1 6 4 4 4 4 1 1 1 1 1 4 4 4 1 1 1 1 1 4 1 1 1 4 4 4 4 6 1 1 1 2 2 2 2 2 6
6 1 1 1 6 1 1 6 1 1 1 1 1 1 6 4 4 4 4 1 1 1 1 1 4 4 4 1 1 1 1 4 4 1 1 4 4 4 4 4 6 1 1 1 2 2 2 2 2 6
6 1 1 4 6 1 1 6 6 6 6 1 6 6 6 4 4 4 4 1 1 1 1 1 4 4 4 1 1 1 1 4 4 1 1 4 4 4 4 4 6 4 1 1 2 2 2 2 2 6
6 1 1 1 6 1 1 1 1 1 1 1 1 1 6 4 4 4 4 1 1 1 1 1 4 4 4 1 1 1 1 4 4 1 1 1 4 4 4 4 6 1 1 1 2 2 2 2 2 6
6 4 1 1 6 1 1 1 1 1 1 1 1 1 6 4 4 4 4 1 1 1 1 1 4 4 4 1 1 1 1 4 4 4 1 1 4 4 4 4 6 1 1 4 2 2 2 2 2 6
6 1 1 1 6 1 1 1 1 1 1 1 1 1 6 4 4 4 4 1 1 1 1 1 4 4 4 4 4 1 1 4 4 4 1 1 1 4 4 1 6 1 1 1 2 2 2 2 2 6
6 1 1 1 6 6 6 6 6 6 6 6 6 6 6 4 4 4 4 4 4 1 1 1 4 4 4 4 4 1 1 4 4 4 1 1 1 4 4 1 6 4 1 1 2 2 2 2 2 6
6 1 1 1 1 1 1 1 1 1 1 1 1 1 6 4 4 4 4 4 4 1 1 1 4 4 4 4 4 1 1 4 4 4 1 1 1 1 1 1 6 1 1 1 2 2 2 2 2 6
6 1 4 1 1 1 1 1 1 1 1 1 1 1 6 4 4 4 4 4 4 1 1 1 1 1 1 4 4 1 1 4 4 4 1 1 1 6 6 6 6 0 0 1 2 2 2 2 2 6
6 1 1 2 2 2 2 2 2 2 2 2 1 1 6 4 4 4 4 4 4 1 1 1 1 1 1 4 4 1 1 4 4 4 1 1 1 1 1 1 6 0 4 1 2 2 2 2 2 6
6 1 1 2 2 2 2 2 2 2 2 2 4 1 6 4 4 4 4 1 1 1 1 1 1 1 1 4 4 1 1 4 4 4 1 1 4 1 1 1 6 0 4 1 2 2 2 2 2 6
6 1 1 2 2 2 2 2 2 2 2 2 1 1 6 4 4 4 4 4 1 1 1 1 4 4 4 4 4 1 1 4 4 4 1 1 1 1 4 4 6 0 0 1 2 2 2 2 2 6
6 1 1 2 2 2 2 2 2 2 2 2 1 1 6 4 4 4 4 4 1 1 1 1 1 1 1 1 1 1 1 4 4 4 1 1 4 4 4 4 6 1 1 1 2 2 2 2 2 6
6 1 1 2 2 2 2 2 2 2 2 2 1 1 6 4 4 4 4 1 1 1 1 1 1 1 1 1 1 1 1 4 4 4 1 1 1 1 4 4 6 1 1 4 2 2 2 2 2 6
6 1 1 2 2 2 2 2 2 2 2 2 1 1 6 4 4 4 4 1 1 6 6 6 6 6 6 6 6 6 6 4 4 4 1 1 1 1 4 4 6 1 1 1 2 2 2 2 2 6
6 1 1 2 2 2 2 2 2 2 2 2 1 1 1 1 1 1 1 1 1 6 1 1 1 1 1 1 4 1 6 4 4 4 4 1 1 1 4 4 4 4 1 1 2 2 2 2 2 6
6 1 1 2 2 2 2 2 2 2 2 2 1 1 1 1 1 1 1 1 1 6 1 1 1 1 1 1 1 1 6 4 4 4 4 1 1 1 4 4 4 4 1 1 2 2 2 2 2 6
6 1 1 2 2 2 2 2 2 2 2 2 1 1 6 6 6 6 6 6 6 6 1 6 6 6 6 1 1 1 6 4 4 4 1 1 1 1 1 4 4 4 1 1 2 2 2 2 2 6
6 1 1 2 2 2 2 2 2 2 2 2 1 1 2 2 2 1 1 1 1 6 1 1 1 1 6 1 1 1 6 4 4 4 1 1 1 1 1 4 4 4 1 1 2 2 2 2 2 6
6 1 1 2 2 2 2 2 2 2 2 2 1 1 2 2 2 1 1 1 1 6 1 1 1 1 6 1 1 1 6 4 4 4 1 1 4 1 1 4 4 4 1 1 2 2 2 2 2 6
6 1 1 2 2 2 2 2 2 2 2 2 1 1 2 2 2 1 1 1 1 6 1 1 1 1 6 1 1 1 6 4 4 4 1 1 1 1 1 4 4 4 1 1 2 2 2 2 2 6
6 1 1 2 2 2 2 2 2 2 2 2 1 1 2 2 2 1 1 1 1 6 1 1 1 1 6 1 1 1 6 4 4 4 1 1 1 4 4 4 4 4 1 4 2 2 2 2 2 6
6 1 1 2 2 2 2 2 2 2 2 2 1 1 2 2 2 1 1 1 1 6 1 1 1 1 6 1 1 1 6 4 4 4 1 1 1 4 4 4 4 4 1 1 2 2 2 2 2 6
6 1 1 2 2 2 2 2 2 2 2 2 1 1 2 2 2 1 1 1 1 6 1 1 6 6 6 1 1 1 6 1 4 4 1 1 1 4 4 4 4 4 1 1 2 2 2 2 2 6
6 1 1 2 2 2 2 2 2 2 2 2 1 1 2 2 2 1 1 1 1 6 1 1 1 1 6 1 1 1 6 1 4 4 1 1 1 4 4 4 4 4 1 1 2 2 2 2 2 6
6 1 1 2 2 2 2 2 2 2 2 2 1 1 2 2 2 1 1 1 1 6 1 1 1 1 6 1 1 1 6 1 4 4 1 1 1 1 1 4 4 4 1 1 2 2 2 2 2 6
6 1 1 2 2 2 2 2 2 2 2 2 1 1 2 2 2 1 1 1 1 6 6 6 6 6 6 1 1 1 6 1 4 4 1 1 1 1 1 4 4 4 1 1 2 2 2 2 2 6
6 1 1 2 2 2 2 2 2 2 2 2 4 1 2 2 2 1 1 1 1 1 1 1 1 1 1 1 1 1 6 1 1 1 1 1 1 1 1 1 1 1 1 1 2 2 2 2 2 6
6 1 1 1 1 1 1 1 1 1 1 1 1 1 1 1 1 1 1 4 1 1 1 1 1 1 1 1 1 1 6 1 1 4 1 1 4 1 1 1 1 1 1 1 2 2 2 2 2 6
6 1 1 1 1 1 1 1 1 1 1 1 1 1 1 1 1 1 1 1 1 1 1 1 1 1 1 1 1 1 6 1 1 1 1 1 4 1 1 1 1 1 1 4 2 2 2 2 2 6
6 6 6 6 6 6 6 6 6 6 6 6 6 6 6 6 6 6 6 6 6 6 6 6 6 6 6 6 6 6 6 6 6 6 6 6 6 6 6 6 6 6 6 6 6 6 6 6 6 6